при=вет
про=вор=ный
тет=радь
фальши=вый
кто-ни=будь
спорт=зал
само=свал
тру=бо=про=вод
аэро=порт
по-че=ло=ве=че=ски
в-тре=тьих
во=рон
ча=стый
лю=тик
даль=но=бой=щик
ро=ди=те=ли
на=хо=дим
вы=би=ра=ем
го=род
чи=сло=вой
диа=по=зон
па=роль
при=зыв
од=на=ко
го=лубь
муж=чи=на
до=стиг=нуть
откры=ла
мо=ло=дой
че=ло=век
